@.#.$#..$.#.$#.$
.##..##..##..##.
.#....#..#....#.
.##..##..##..##.
..#..#....#..#..
................
..#...#...#...#.
................
..#...#...#...#.
................
..#...#...#..#..
.##...##.##..##.
.#.....#.#....#.
.##...##.##..##.
..#...#...#..#..
.##.$.##$##$.##$