$.....$.$.....$.
.$...........$..
..$.........$...
...$.......$....
....$.....$.....
.....$.#.$......
$.....$.$......$
.....#.@.#......
$.....$.$......$
.....$.#.$......
....$.....$.....
...$.......$....
..$.........$...
.$...........$..
$.............$.
......$.$......$