@#.##...$..##..$
...#$.#.##..#$#.
.#...#...##.#.#.
.##$.##.$...#.$.
.$#...#..$.##.#.
.##.$..........$
..#..##.##.###..
#.$.##.$#...#$.#
#..##$..#.#.#.##
#$.#..#.#$#.#...
...$..#...#$..##
.#$#.##..##.#$..
###.#.$.##..###.
.$..$##..#....$.
.###..##.##.#.##
$.#..$....$.#.$#