....#......#....
.@..............
....#......#....
...###....###...
................
................
................
................
####........####
................
................
................
...#$.....$.#...
...#........#...
.$.####..####.$.
...#........#...