................
.#......@.......
###..........###
..............#.
................
................
................
................
................
................
................
................
.#..............
###..........###
..............#.
.$............$.