.............$..
#.#.#.#.#.#.#.#.
.@..............
#.#.#.#.#.#.#.#.
.......$........
#.#.#.#.#.#.#.#.
.........$......
#.#.#.#.#.#.#.#.
.....$..........
#.#.#.#.#.#.#.#.
.........$......
#.#.#.#.#.#.#.#.
.............$..
#.#.#.#.#.#.#.#.
...$...........$
#.#.#.#.#.#.#.#.